0 0 0 0 0 0 0 0 0 0 1 1 1 0 0 0 0 0 0 0 0 0 0 0 0 0 0 0 0 0
0 11 1 9 7 9 2 1 9 7 9 2 1 9 7 9 2 1 9 7 9 2 1 9 7 9 2 7 9 0
0 12 17 10 8 10 1 17 10 8 10 1 17 10 8 10 1 17 10 8 10 1 17 10 8 10 1 8 10 0
0 21 21 21 21 21 21 21 21 21 21 21 21 21 21 21 21 21 21 21 21 21 21 21 21 21 21 21 21 0
0 21 21 21 21 21 21 21 21 21 21 21 21 21 21 21 21 21 21 21 21 21 21 21 21 21 21 21 21 0
0 19 19 3 21 21 2 19 19 19 19 19 19 3 21 21 2 19 19 19 19 19 19 3 21 21 2 19 19 0
0 23 23 4 21 21 23 23 23 23 23 23 23 4 21 21 23 23 23 23 23 23 23 4 21 21 23 23 23 0
0 23 20 21 21 21 21 21 21 20 21 21 21 21 21 21 21 21 21 21 20 21 21 21 21 21 21 20 23 0
0 23 20 21 21 21 21 21 21 20 21 21 21 21 21 21 21 21 21 21 20 21 21 21 21 21 21 20 23 0
0 23 23 0 21 21 23 23 23 23 23 23 23 0 0 0 23 23 23 23 23 23 23 5 21 21 23 23 23 0
0 24 24 0 21 21 25 25 25 25 25 25 25 25 25 25 25 25 25 25 25 25 25 25 21 21 25 25 25 0
0 5 0 2 21 21 21 21 21 21 21 21 21 21 21 21 21 21 21 21 21 21 21 21 21 21 21 21 21 0
0 1 0 0 21 21 21 21 21 21 21 21 21 21 21 21 21 21 21 21 21 21 21 21 21 21 21 21 21 0
0 0 0 0 19 19 19 19 19 19 19 19 19 19 19 19 19 19 19 19 19 19 19 19 19 19 19 19 19 0
0 1 0 1 0 0 0 1 0 0 0 0 0 0 0 0 0 1 0 0 0 1 0 0 0 0 1 0 0 0
0 0 0 0 0 0 1 1 0 0 0 0 1 0 0 0 0 0 1 0 0 0 0 0 0 0 0 0 0 0